date,ts,total_positives,student_positives,staff_positives,faculty_positives,tests_administered,cumulative_total_positives,total_positives_rolling_avg,cumulative_student_positives,student_positives_rolling_avg,cumulative_staff_positives,staff_positives_rolling_avg,cumulative_faculty_positives,faculty_positives_rolling_avg,cumulative_tests_administered,tests_administered_rolling_avg
9/1/2020,1598932800000,7,7,0,0,1259,7,,7,,0,,0,,1259,
9/2/2020,1599019200000,12,12,0,0,385,19,,19,,0,,0,,1644,
9/3/2020,1599105600000,12,12,0,0,4646,31,,31,,0,,0,,6290,
9/4/2020,1599192000000,14,14,0,0,4978,45,,45,,0,,0,,11268,
9/5/2020,1599278400000,6,6,0,0,2857,51,,51,,0,,0,,14125,
9/6/2020,1599364800000,5,5,0,0,2894,56,,56,,0,,0,,17019,
9/7/2020,1599451200000,6,6,0,0,5026,62,8.857142857142858,62,8.857142857142858,0,0,0,0,22045,3149.285714285714
9/8/2020,1599537600000,3,3,0,0,4730,65,8.285714285714286,65,8.285714285714286,0,0,0,0,26775,3645.1428571428573
9/9/2020,1599624000000,13,13,0,0,3872,78,8.428571428571429,78,8.428571428571429,0,0,0,0,30647,4143.285714285715
9/10/2020,1599710400000,6,5,1,0,5117,84,7.571428571428571,83,7.428571428571429,1,0.14285714285714285,0,0,35764,4210.571428571428
9/11/2020,1599796800000,4,4,0,0,5121,88,6.142857142857143,87,6,1,0.14285714285714285,0,0,40885,4231
9/12/2020,1599883200000,3,3,0,0,2770,91,5.714285714285714,90,5.571428571428571,1,0.14285714285714285,0,0,43655,4218.571428571428
9/13/2020,1599969600000,0,0,0,0,2914,91,5,90,4.857142857142857,1,0.14285714285714285,0,0,46569,4221.428571428572
9/14/2020,1600056000000,0,0,0,0,5969,91,4.142857142857143,90,4,1,0.14285714285714285,0,0,52538,4356.142857142857
9/15/2020,1600142400000,0,0,0,0,5228,91,3.7142857142857144,90,3.5714285714285716,1,0.14285714285714285,0,0,57766,4427.285714285715
9/16/2020,1600228800000,1,1,0,0,5010,92,2,91,1.8571428571428572,1,0.14285714285714285,0,0,62776,4589.857142857143
9/17/2020,1600315200000,0,0,0,0,5483,92,1.1428571428571428,91,1.1428571428571428,1,0,0,0,68259,4642.142857142857
9/18/2020,1600401600000,1,1,0,0,5509,93,0.7142857142857143,92,0.7142857142857143,1,0,0,0,73768,4697.571428571428
9/19/2020,1600488000000,0,0,0,0,2705,93,0.2857142857142857,92,0.2857142857142857,1,0,0,0,76473,4688.285714285715
9/20/2020,1600574400000,1,0,1,0,2797,94,0.42857142857142855,92,0.2857142857142857,2,0.14285714285714285,0,0,79270,4671.571428571428
9/21/2020,1600660800000,2,1,1,0,5958,96,0.7142857142857143,93,0.42857142857142855,3,0.2857142857142857,0,0,85228,4670
9/22/2020,1600747200000,1,1,0,0,5276,97,0.8571428571428571,94,0.5714285714285714,3,0.2857142857142857,0,0,90504,4676.857142857143
9/23/2020,1600833600000,1,1,0,0,5275,98,0.8571428571428571,95,0.5714285714285714,3,0.2857142857142857,0,0,95779,4714.714285714285
9/24/2020,1600920000000,0,0,0,0,5865,98,0.8571428571428571,95,0.5714285714285714,3,0.2857142857142857,0,0,101644,4769.285714285715
9/25/2020,1601006400000,1,0,1,0,5776,99,0.8571428571428571,95,0.42857142857142855,4,0.42857142857142855,0,0,107420,4807.428571428572
9/26/2020,1601092800000,1,0,1,0,2676,100,1,95,0.42857142857142855,5,0.5714285714285714,0,0,110096,4803.285714285715
9/27/2020,1601179200000,0,0,0,0,3105,100,0.8571428571428571,95,0.42857142857142855,5,0.42857142857142855,0,0,113201,4847.285714285715
9/28/2020,1601265600000,1,1,0,0,6301,101,0.7142857142857143,96,0.42857142857142855,5,0.2857142857142857,0,0,119502,4896.285714285715
9/29/2020,1601352000000,1,1,0,0,5714,102,0.7142857142857143,97,0.42857142857142855,5,0.2857142857142857,0,0,125216,4958.857142857143
9/30/2020,1601438400000,0,0,0,0,5536,102,0.5714285714285714,97,0.2857142857142857,5,0.2857142857142857,0,0,130752,4996.142857142857
10/1/2020,1601524800000,0,0,0,0,5905,102,0.5714285714285714,97,0.2857142857142857,5,0.2857142857142857,0,0,136657,5001.857142857143
10/2/2020,1601611200000,2,2,0,0,5889,104,0.7142857142857143,99,0.5714285714285714,5,0.14285714285714285,0,0,142546,5018
10/3/2020,1601697600000,0,0,0,0,2913,104,0.5714285714285714,99,0.5714285714285714,5,0,0,0,145459,5051.857142857143
10/4/2020,1601784000000,0,0,0,0,2970,104,0.5714285714285714,99,0.5714285714285714,5,0,0,0,148429,5032.571428571428
10/5/2020,1601870400000,2,2,0,0,6386,106,0.7142857142857143,101,0.7142857142857143,5,0,0,0,154815,5044.714285714285
10/6/2020,1601956800000,1,1,0,0,5629,107,0.7142857142857143,102,0.7142857142857143,5,0,0,0,160444,5032.571428571428
10/7/2020,1602043200000,1,1,0,0,5407,108,0.8571428571428571,103,0.8571428571428571,5,0,0,0,165851,5014.142857142857
10/8/2020,1602129600000,1,0,1,0,5855,109,1,103,0.8571428571428571,6,0.14285714285714285,0,0,171706,5007
10/9/2020,1602216000000,0,0,0,0,5973,109,0.7142857142857143,103,0.5714285714285714,6,0.14285714285714285,0,0,177679,5019
10/10/2020,1602302400000,0,0,0,0,2769,109,0.7142857142857143,103,0.5714285714285714,6,0.14285714285714285,0,0,180448,4998.428571428572
10/11/2020,1602388800000,0,0,0,0,3047,109,0.7142857142857143,103,0.5714285714285714,6,0.14285714285714285,0,0,183495,5009.428571428572
10/12/2020,1602475200000,0,0,0,0,6221,109,0.42857142857142855,103,0.2857142857142857,6,0.14285714285714285,0,0,189716,4985.857142857143
10/13/2020,1602561600000,0,0,0,0,5557,109,0.2857142857142857,103,0.14285714285714285,6,0.14285714285714285,0,0,195273,4975.571428571428
10/14/2020,1602648000000,2,0,2,0,5304,111,0.42857142857142855,103,0,8,0.42857142857142855,0,0,200577,4960.857142857143
10/15/2020,1602734400000,3,1,2,0,5957,114,0.7142857142857143,104,0.14285714285714285,10,0.5714285714285714,0,0,206534,4975.428571428572
10/16/2020,1602820800000,1,1,0,0,5876,115,0.8571428571428571,105,0.2857142857142857,10,0.5714285714285714,0,0,212410,4961.571428571428
10/17/2020,1602907200000,1,0,1,0,2878,116,1,105,0.2857142857142857,11,0.7142857142857143,0,0,215288,4977.142857142857
10/18/2020,1602993600000,0,0,0,0,2935,116,1,105,0.2857142857142857,11,0.7142857142857143,0,0,218223,4961.142857142857
10/19/2020,1603080000000,3,3,0,0,6270,119,1.4285714285714286,108,0.7142857142857143,11,0.7142857142857143,0,0,224493,4968.142857142857
10/20/2020,1603166400000,0,0,0,0,5683,119,1.4285714285714286,108,0.7142857142857143,11,0.7142857142857143,0,0,230176,4986.142857142857
10/21/2020,1603252800000,3,0,3,0,5502,122,1.5714285714285714,108,0.7142857142857143,14,0.8571428571428571,0,0,235678,5014.428571428572
10/22/2020,1603339200000,1,0,1,0,5855,123,1.2857142857142858,108,0.5714285714285714,15,0.7142857142857143,0,0,241533,4999.857142857143
10/23/2020,1603425600000,2,1,1,0,5880,125,1.4285714285714286,109,0.5714285714285714,16,0.8571428571428571,0,0,247413,5000.428571428572
10/24/2020,1603512000000,0,0,0,0,2827,125,1.2857142857142858,109,0.5714285714285714,16,0.7142857142857143,0,0,250240,4993.142857142857
10/25/2020,1603598400000,0,0,0,0,3060,125,1.2857142857142858,109,0.5714285714285714,16,0.7142857142857143,0,0,253300,5011
10/26/2020,1603684800000,0,0,0,0,6366,125,0.8571428571428571,109,0.14285714285714285,16,0.7142857142857143,0,0,259666,5024.714285714285
10/27/2020,1603771200000,0,0,0,0,5699,125,0.8571428571428571,109,0.14285714285714285,16,0.7142857142857143,0,0,265365,5027
10/28/2020,1603857600000,3,2,1,0,5398,128,0.8571428571428571,111,0.42857142857142855,17,0.42857142857142855,0,0,270763,5012.142857142857
10/29/2020,1603944000000,2,0,2,0,5814,130,1,111,0.42857142857142855,19,0.5714285714285714,0,0,276577,5006.285714285715
10/30/2020,1604030400000,4,2,2,0,5909,134,1.2857142857142858,113,0.5714285714285714,21,0.7142857142857143,0,0,282486,5010.428571428572
10/31/2020,1604116800000,0,0,0,0,2845,134,1.2857142857142858,113,0.5714285714285714,21,0.7142857142857143,0,0,285331,5013
11/1/2020,1604203200000,1,0,1,0,2970,135,1.4285714285714286,113,0.5714285714285714,22,0.8571428571428571,0,0,288301,5000.142857142857
11/2/2020,1604293200000,1,0,1,0,6308,136,1.5714285714285714,113,0.5714285714285714,23,1,0,0,294609,4991.857142857143
11/3/2020,1604379600000,2,1,1,0,5643,138,1.8571428571428572,114,0.7142857142857143,24,1.1428571428571428,0,0,300252,4983.857142857143
11/4/2020,1604466000000,5,1,4,0,5447,143,2.142857142857143,115,0.5714285714285714,28,1.5714285714285714,0,0,305699,4990.857142857143
11/5/2020,1604552400000,2,0,2,0,5931,145,2.142857142857143,115,0.5714285714285714,30,1.5714285714285714,0,0,311630,5007.571428571428
11/6/2020,1604638800000,2,0,2,0,5842,147,1.8571428571428572,115,0.2857142857142857,32,1.5714285714285714,0,0,317472,4998
11/7/2020,1604725200000,1,1,0,0,2814,148,2,116,0.42857142857142855,32,1.5714285714285714,0,0,320286,4993.571428571428
11/8/2020,1604811600000,1,1,0,0,3024,149,2,117,0.5714285714285714,32,1.4285714285714286,0,0,323310,5001.285714285715
11/9/2020,1604898000000,2,0,2,0,6419,151,2.142857142857143,117,0.5714285714285714,34,1.5714285714285714,0,0,329729,5017.142857142857
11/10/2020,1604984400000,0,0,0,0,5622,151,1.8571428571428572,117,0.42857142857142855,34,1.4285714285714286,0,0,335351,5014.142857142857
11/11/2020,1605070800000,6,6,0,0,5443,157,2,123,1.1428571428571428,34,0.8571428571428571,0,0,340794,5013.571428571428
11/12/2020,1605157200000,14,12,2,0,5859,171,3.7142857142857144,135,2.857142857142857,36,0.8571428571428571,0,0,346653,5003.285714285715
11/13/2020,1605243600000,9,7,2,0,6031,180,4.714285714285714,142,3.857142857142857,38,0.8571428571428571,0,0,352684,5030.285714285715
11/14/2020,1605330000000,6,6,0,0,2905,186,5.428571428571429,148,4.571428571428571,38,0.8571428571428571,0,0,355589,5043.285714285715
11/15/2020,1605416400000,2,2,0,0,2845,188,5.571428571428571,150,4.714285714285714,38,0.8571428571428571,0,0,358434,5017.714285714285
11/16/2020,1605502800000,2,1,1,0,6005,190,5.571428571428571,151,4.857142857142857,39,0.7142857142857143,0,0,364439,4958.571428571428
11/17/2020,1605589200000,1,1,0,0,5250,191,5.714285714285714,152,5,39,0.7142857142857143,0,0,369689,4905.428571428572
11/18/2020,1605675600000,0,0,0,0,5072,191,4.857142857142857,152,4.142857142857143,39,0.7142857142857143,0,0,374761,4852.428571428572
11/19/2020,1605762000000,2,1,1,0,5186,193,3.142857142857143,153,2.5714285714285716,40,0.5714285714285714,0,0,379947,4756.285714285715
11/20/2020,1605848400000,11,3,8,0,5237,204,3.4285714285714284,156,2,48,1.4285714285714286,0,0,385184,4642.857142857143
11/21/2020,1605934800000,2,2,0,0,2404,206,2.857142857142857,158,1.4285714285714286,48,1.4285714285714286,0,0,387588,4571.285714285715
11/22/2020,1606021200000,2,2,0,0,2138,208,2.857142857142857,160,1.4285714285714286,48,1.4285714285714286,0,0,389726,4470.285714285715
11/23/2020,1606107600000,4,1,3,0,4412,212,3.142857142857143,161,1.4285714285714286,51,1.7142857142857142,0,0,394138,4242.714285714285
11/24/2020,1606194000000,3,0,3,0,3879,215,3.4285714285714284,161,1.2857142857142858,54,2.142857142857143,0,0,398017,4046.8571428571427
11/25/2020,1606280400000,3,1,2,0,48,218,3.857142857142857,162,1.4285714285714286,56,2.4285714285714284,0,0,398065,3329.1428571428573
11/26/2020,1606366800000,4,1,3,0,,222,4.142857142857143,163,1.4285714285714286,59,2.7142857142857144,0,0,398065,2588.285714285714
11/27/2020,1606453200000,1,1,0,0,2472,223,2.7142857142857144,164,1.1428571428571428,59,1.5714285714285714,0,0,400537,2193.285714285714
11/28/2020,1606539600000,0,0,0,0,1028,223,2.4285714285714284,164,0.8571428571428571,59,1.5714285714285714,0,0,401565,1996.7142857142858
11/29/2020,1606626000000,3,0,3,0,1162,226,2.5714285714285716,164,0.5714285714285714,62,2,0,0,402727,1857.2857142857142
11/30/2020,1606712400000,4,0,4,0,3729,230,2.5714285714285716,164,0.42857142857142855,66,2.142857142857143,0,0,406456,1759.7142857142858
12/1/2020,1606798800000,9,7,2,0,3132,239,3.4285714285714284,171,1.4285714285714286,68,2,0,0,409588,1653
12/2/2020,1606885200000,3,1,2,0,2779,242,3.4285714285714284,172,1.4285714285714286,70,2,0,0,412367,2043.142857142857
12/3/2020,1606971600000,7,2,5,0,3221,249,3.857142857142857,174,1.5714285714285714,75,2.2857142857142856,0,0,415588,2503.285714285714
12/4/2020,1607058000000,3,0,3,0,3741,252,4.142857142857143,174,1.4285714285714286,78,2.7142857142857144,0,0,419329,2684.5714285714284
12/5/2020,1607144400000,3,0,3,0,167,255,4.571428571428571,174,1.4285714285714286,81,3.142857142857143,0,0,419496,2561.5714285714284
12/6/2020,1607230800000,4,1,3,0,30,259,4.714285714285714,175,1.5714285714285714,84,3.142857142857143,0,0,419526,2399.8571428571427
12/7/2020,1607317200000,4,1,3,0,4013,263,4.714285714285714,176,1.7142857142857142,87,3,0,0,423539,2440.4285714285716
12/8/2020,1607403600000,8,0,8,0,3135,271,4.571428571428571,176,0.7142857142857143,95,3.857142857142857,0,0,426674,2440.8571428571427
12/9/2020,1607490000000,2,1,1,0,2758,273,4.428571428571429,177,0.7142857142857143,96,3.7142857142857144,0,0,429432,2437.8571428571427
12/10/2020,1607576400000,2,1,1,0,2998,275,3.7142857142857144,178,0.5714285714285714,97,3.142857142857143,0,0,432430,2406
12/11/2020,1607662800000,8,2,6,0,3938,283,4.428571428571429,180,0.8571428571428571,103,3.5714285714285716,0,0,436368,2434.1428571428573
12/12/2020,1607749200000,6,2,4,0,117,289,4.857142857142857,182,1.1428571428571428,107,3.7142857142857144,0,0,436485,2427
12/13/2020,1607835600000,3,0,3,0,34,292,4.714285714285714,182,1,110,3.7142857142857144,0,0,436519,2427.5714285714284
12/14/2020,1607922000000,4,0,4,0,3725,296,4.714285714285714,182,0.8571428571428571,114,3.857142857142857,0,0,440244,2386.4285714285716
12/15/2020,1608008400000,2,0,2,0,3042,298,3.857142857142857,182,0.8571428571428571,116,3,0,0,443286,2373.1428571428573
12/16/2020,1608094800000,5,2,3,0,2673,303,4.285714285714286,184,1,119,3.2857142857142856,0,0,445959,2361
12/17/2020,1608181200000,4,1,3,0,2143,307,4.571428571428571,185,1,122,3.5714285714285716,0,0,448102,2238.8571428571427
12/18/2020,1608267600000,4,1,3,0,3867,311,4,186,0.8571428571428571,125,3.142857142857143,0,0,451969,2228.714285714286
12/19/2020,1608354000000,5,3,2,0,176,316,3.857142857142857,189,1,127,2.857142857142857,0,0,452145,2237.1428571428573
12/20/2020,1608440400000,3,0,3,0,70,319,3.857142857142857,189,1,130,2.857142857142857,0,0,452215,2242.285714285714
12/21/2020,1608526800000,3,2,1,0,3056,322,3.7142857142857144,191,1.2857142857142858,131,2.4285714285714284,0,0,455271,2146.714285714286
12/22/2020,1608613200000,2,0,2,0,2807,324,3.7142857142857144,191,1.2857142857142858,133,2.4285714285714284,0,0,458078,2113.1428571428573
12/23/2020,1608699600000,1,0,1,0,2237,325,3.142857142857143,191,1,134,2.142857142857143,0,0,460315,2050.8571428571427
12/24/2020,1608786000000,8,1,7,0,79,333,3.7142857142857144,192,1,141,2.7142857142857144,0,0,460394,1756
12/25/2020,1608872400000,0,0,0,0,18,333,3.142857142857143,192,0.8571428571428571,141,2.2857142857142856,0,0,460412,1206.142857142857
12/26/2020,1608958800000,1,0,1,0,1431,334,2.5714285714285716,192,0.42857142857142855,142,2.142857142857143,0,0,461843,1385.4285714285713
12/27/2020,1609045200000,1,0,1,0,76,335,2.2857142857142856,192,0.42857142857142855,143,1.8571428571428572,0,0,461919,1386.2857142857142
12/28/2020,1609131600000,9,1,8,0,1691,344,3.142857142857143,193,0.2857142857142857,151,2.857142857142857,0,0,463610,1191.2857142857142
12/29/2020,1609218000000,6,3,2,1,1526,350,3.7142857142857144,196,0.7142857142857143,153,2.857142857142857,1,0.14285714285714285,465136,1008.2857142857143
12/30/2020,1609304400000,3,2,1,0,1362,353,4,198,1,154,2.857142857142857,1,0.14285714285714285,466498,883.2857142857143
12/31/2020,1609390800000,5,3,2,0,70,358,3.5714285714285716,201,1.2857142857142858,156,2.142857142857143,1,0.14285714285714285,466568,882
1/1/2021,1609477200000,1,1,0,0,18,359,3.7142857142857144,202,1.4285714285714286,156,2.142857142857143,1,0.14285714285714285,466586,882
1/2/2021,1609563600000,4,1,3,0,1907,363,4.142857142857143,203,1.5714285714285714,159,2.4285714285714284,1,0.14285714285714285,468493,950
1/3/2021,1609650000000,1,1,0,0,54,364,4.142857142857143,204,1.7142857142857142,159,2.2857142857142856,1,0.14285714285714285,468547,946.8571428571429
1/4/2021,1609736400000,2,2,0,0,2977,366,3.142857142857143,206,1.8571428571428572,159,1.1428571428571428,1,0.14285714285714285,471524,1130.5714285714287
1/5/2021,1609822800000,9,2,7,0,1935,375,3.5714285714285716,208,1.7142857142857142,166,1.8571428571428572,1,0,473459,1189
1/6/2021,1609909200000,4,4,0,0,2563,379,3.7142857142857144,212,2,166,1.7142857142857142,1,0,476022,1360.5714285714287
1/7/2021,1609995600000,11,0,9,2,2202,390,4.571428571428571,212,1.5714285714285714,175,2.7142857142857144,3,0.2857142857142857,478224,1665.142857142857
1/8/2021,1610082000000,1,0,1,0,1961,391,4.571428571428571,212,1.4285714285714286,176,2.857142857142857,3,0.2857142857142857,480185,1942.7142857142858
1/9/2021,1610168400000,1,1,6,0,638,392,4.142857142857143,213,1.4285714285714286,182,3.2857142857142856,3,0.2857142857142857,480823,1761.4285714285713
1/10/2021,1610254800000,2,0,2,0,586,394,4.285714285714286,213,1.2857142857142858,184,3.5714285714285716,3,0.2857142857142857,481409,1837.4285714285713
1/11/2021,1610341200000,2,1,1,0,2166,396,4.285714285714286,214,1.1428571428571428,185,3.7142857142857144,3,0.2857142857142857,483575,1721.5714285714287
1/12/2021,1610427600000,5,2,3,0,2197,401,3.7142857142857144,216,1.1428571428571428,188,3.142857142857143,3,0.2857142857142857,485772,1759
1/13/2021,1610514000000,1,0,1,0,2695,402,3.2857142857142856,216,0.5714285714285714,189,3.2857142857142856,3,0.2857142857142857,488467,1777.857142857143
1/14/2021,1610600400000,3,2,0,1,2384,405,2.142857142857143,218,0.8571428571428571,189,2,4,0.14285714285714285,490851,1803.857142857143
1/15/2021,1610686800000,4,1,3,0,2286,409,2.5714285714285716,219,1,192,2.2857142857142856,4,0.14285714285714285,493137,1850.2857142857142
1/16/2021,1610773200000,3,2,1,0,808,412,2.857142857142857,221,1.1428571428571428,193,1.5714285714285714,4,0.14285714285714285,493945,1874.5714285714287
1/17/2021,1610859600000,1,1,0,0,643,413,2.7142857142857144,222,1.2857142857142858,193,1.2857142857142858,4,0.14285714285714285,494588,1882.7142857142858
1/18/2021,1610946000000,12,1,10,1,1972,425,4.142857142857143,223,1.2857142857142858,203,2.5714285714285716,5,0.2857142857142857,496560,1855
1/19/2021,1611032400000,0,0,0,0,2920,425,3.4285714285714284,223,1,203,2.142857142857143,5,0.2857142857142857,499480,1958.2857142857142
1/20/2021,1611118800000,7,3,3,1,2952,432,4.285714285714286,226,1.4285714285714286,206,2.4285714285714284,6,0.42857142857142855,502432,1995
1/21/2021,1611205200000,10,5,5,0,2956,442,5.285714285714286,231,1.8571428571428572,211,3.142857142857143,6,0.2857142857142857,505388,2076.714285714286
1/22/2021,1611291600000,8,5,3,0,2542,450,5.857142857142857,236,2.4285714285714284,214,3.142857142857143,6,0.2857142857142857,507930,2113.285714285714
1/23/2021,1611378000000,7,5,2,0,1627,457,6.428571428571429,241,2.857142857142857,216,3.2857142857142856,6,0.2857142857142857,509557,2230.285714285714
1/24/2021,1611464400000,7,6,1,0,1599,464,7.285714285714286,247,3.5714285714285716,217,3.4285714285714284,6,0.2857142857142857,511156,2366.8571428571427
1/25/2021,1611550800000,8,7,1,0,3766,472,6.714285714285714,254,4.428571428571429,218,2.142857142857143,6,0.14285714285714285,514922,2623.1428571428573
1/26/2021,1611637200000,8,5,3,0,3383,480,7.857142857142857,259,5.142857142857143,221,2.5714285714285716,6,0.14285714285714285,518305,2689.285714285714
1/27/2021,1611723600000,5,4,1,0,3816,485,7.571428571428571,263,5.285714285714286,222,2.2857142857142856,6,0,522121,2812.714285714286
1/28/2021,1611810000000,15,12,3,0,3719,500,8.285714285714286,275,6.285714285714286,225,2,6,0,525840,2921.714285714286
1/29/2021,1611896400000,8,6,2,0,4216,508,8.285714285714286,281,6.428571428571429,227,1.8571428571428572,6,0,530056,3160.8571428571427
1/30/2021,1611982800000,6,5,0,1,2250,514,8.142857142857142,286,6.428571428571429,227,1.5714285714285714,7,0.14285714285714285,532306,3249.8571428571427
1/31/2021,1612069200000,7,5,1,1,3237,521,8.142857142857142,291,6.285714285714286,228,1.5714285714285714,8,0.2857142857142857,535543,3483.8571428571427
2/1/2021,1612155600000,12,12,0,0,4620,533,8.714285714285714,303,7,228,1.4285714285714286,8,0.2857142857142857,540163,3605.8571428571427
2/2/2021,1612242000000,6,5,1,0,3811,539,8.428571428571429,308,7,229,1.1428571428571428,8,0.2857142857142857,543974,3667
2/3/2021,1612328400000,16,15,1,0,4970,555,10,323,8.571428571428571,230,1.1428571428571428,8,0.2857142857142857,548944,3831.8571428571427
2/4/2021,1612414800000,16,16,0,0,6969,571,10.142857142857142,339,9.142857142857142,230,0.7142857142857143,8,0.2857142857142857,555913,4296.142857142857
2/5/2021,1612501200000,17,17,0,0,5728,588,11.428571428571429,356,10.714285714285714,230,0.42857142857142855,8,0.2857142857142857,561641,4512.142857142857
2/6/2021,1612587600000,16,16,0,0,3604,604,12.857142857142858,372,12.285714285714286,230,0.42857142857142855,8,0.14285714285714285,565245,4705.571428571428
2/7/2021,1612674000000,17,13,4,0,3760,621,14.285714285714286,385,13.428571428571429,234,0.8571428571428571,8,0,569005,4780.285714285715
2/8/2021,1612760400000,3,3,0,0,6362,624,13,388,12.142857142857142,234,0.8571428571428571,8,0,575367,5029.142857142857
2/9/2021,1612846800000,10,10,0,0,6162,634,13.571428571428571,398,12.857142857142858,234,0.7142857142857143,8,0,581529,5365
2/10/2021,1612933200000,4,3,0,1,5534,638,11.857142857142858,401,11.142857142857142,234,0.5714285714285714,9,0.14285714285714285,587063,5445.571428571428
2/11/2021,1613019600000,14,13,1,0,5473,652,11.571428571428571,414,10.714285714285714,235,0.7142857142857143,9,0.14285714285714285,592536,5231.857142857143
2/12/2021,1613106000000,3,3,0,0,5907,655,9.571428571428571,417,8.714285714285714,235,0.7142857142857143,9,0.14285714285714285,598443,5257.428571428572
2/13/2021,1613192400000,2,0,2,0,4293,657,7.571428571428571,417,6.428571428571429,237,1,9,0.14285714285714285,602736,5355.857142857143
2/14/2021,1613278800000,3,2,1,0,3405,660,5.571428571428571,419,4.857142857142857,238,0.5714285714285714,9,0.14285714285714285,606141,5305.142857142857
2/15/2021,1613365200000,2,1,1,0,6866,662,5.428571428571429,420,4.571428571428571,239,0.7142857142857143,9,0.14285714285714285,613007,5377.142857142857
2/16/2021,1613451600000,1,1,0,0,5847,663,4.142857142857143,421,3.2857142857142856,239,0.7142857142857143,9,0.14285714285714285,618854,5332.142857142857
2/17/2021,1613538000000,1,0,1,0,5923,664,3.7142857142857144,421,2.857142857142857,240,0.8571428571428571,9,0,624777,5387.714285714285
2/18/2021,1613624400000,2,0,2,0,6345,666,2,421,1,242,1,9,0,631122,5512.285714285715
2/19/2021,1613710800000,5,4,0,1,6108,671,2.2857142857142856,425,1.1428571428571428,242,1,10,0.14285714285714285,637230,5541
2/20/2021,1613797200000,1,1,0,0,4160,672,2.142857142857143,426,1.2857142857142858,242,0.7142857142857143,10,0.14285714285714285,641390,5522
2/21/2021,1613883600000,5,4,1,0,3398,677,2.4285714285714284,430,1.5714285714285714,243,0.7142857142857143,10,0.14285714285714285,644788,5521
2/22/2021,1613970000000,2,1,1,0,6788,679,2.4285714285714284,431,1.5714285714285714,244,0.7142857142857143,10,0.14285714285714285,651576,5509.857142857143
2/23/2021,1614056400000,4,4,0,0,6302,683,2.857142857142857,435,2,244,0.7142857142857143,10,0.14285714285714285,657878,5574.857142857143
2/24/2021,1614142800000,2,2,0,0,5808,685,3,437,2.2857142857142856,244,0.5714285714285714,10,0.14285714285714285,663686,5558.428571428572
2/25/2021,1614229200000,3,1,2,0,6256,688,3.142857142857143,438,2.4285714285714284,246,0.5714285714285714,10,0.14285714285714285,669942,5545.714285714285
2/26/2021,1614315600000,4,2,2,0,6338,692,3,440,2.142857142857143,248,0.8571428571428571,10,0,676280,5578.571428571428
2/27/2021,1614402000000,2,0,2,0,4228,694,3.142857142857143,440,2,250,1.1428571428571428,10,0,680508,5588.285714285715
2/28/2021,1614488400000,1,1,0,0,3387,695,2.5714285714285716,441,1.5714285714285714,250,1,10,0,683895,5586.714285714285
3/1/2021,1614574800000,4,2,2,0,6936,699,2.857142857142857,443,1.7142857142857142,252,1.1428571428571428,10,0,690831,5607.857142857143
3/2/2021,1614661200000,5,5,0,0,6193,704,3,448,1.8571428571428572,252,1.1428571428571428,10,0,697024,5592.285714285715
3/3/2021,1614747600000,7,7,0,0,5931,711,3.7142857142857144,455,2.5714285714285716,252,1.1428571428571428,10,0,702955,5609.857142857143
3/4/2021,1614834000000,1,9,2,0,6703,712,3.4285714285714284,464,3.7142857142857144,254,1.1428571428571428,10,0,709658,5673.714285714285
3/5/2021,1614920400000,4,2,2,0,6296,716,3.4285714285714284,466,3.7142857142857144,256,1.1428571428571428,10,0,715954,5667.714285714285
3/6/2021,1615006800000,7,7,0,0,4189,723,4.142857142857143,473,4.714285714285714,256,0.8571428571428571,10,0,720143,5662.142857142857
3/7/2021,1615093200000,3,3,0,0,3371,726,4.428571428571429,476,5,256,0.8571428571428571,10,0,723514,5659.857142857143
3/8/2021,1615179600000,6,6,0,0,6976,732,4.714285714285714,482,5.571428571428571,256,0.5714285714285714,10,0,730490,5665.571428571428
3/9/2021,1615266000000,9,8,1,0,6132,741,5.285714285714286,490,6,257,0.7142857142857143,10,0,736622,5656.857142857143
3/10/2021,1615352400000,8,6,1,1,5698,749,5.428571428571429,496,5.857142857142857,258,0.8571428571428571,11,0.14285714285714285,742320,5623.571428571428
3/11/2021,1615438800000,11,11,0,0,6913,760,6.857142857142857,507,6.142857142857143,258,0.5714285714285714,11,0.14285714285714285,749233,5653.571428571428
3/12/2021,1615525200000,9,6,3,0,6440,769,7.571428571428571,513,6.714285714285714,261,0.7142857142857143,11,0.14285714285714285,755673,5674.142857142857
3/13/2021,1615611600000,3,3,0,0,4214,772,7,516,6.142857142857143,261,0.7142857142857143,11,0.14285714285714285,759887,5677.714285714285
3/14/2021,1615698000000,6,6,0,0,3262,778,7.428571428571429,522,6.571428571428571,261,0.7142857142857143,11,0.14285714285714285,763149,5662.142857142857
3/15/2021,1615780800000,10,10,0,0,7207,788,8,532,7.142857142857143,261,0.7142857142857143,11,0.14285714285714285,770356,5695.142857142857
3/16/2021,1615867200000,10,10,0,0,6438,798,8.142857142857142,542,7.428571428571429,261,0.5714285714285714,11,0.14285714285714285,776794,5738.857142857143
3/17/2021,1615953600000,18,18,0,0,6163,816,9.571428571428571,560,9.142857142857142,261,0.42857142857142855,11,0,782957,5805.285714285715
3/18/2021,1616040000000,22,21,1,0,7010,838,11.142857142857142,581,10.571428571428571,262,0.5714285714285714,11,0,789967,5819.142857142857
3/19/2021,1616126400000,10,10,0,0,6965,848,11.285714285714286,591,11.142857142857142,262,0.14285714285714285,11,0,796932,5894.142857142857
3/20/2021,1616212800000,6,6,0,0,4514,854,11.714285714285714,597,11.571428571428571,262,0.14285714285714285,11,0,801446,5937
3/21/2021,1616299200000,4,3,1,0,3472,858,11.428571428571429,600,11.142857142857142,263,0.2857142857142857,11,0,804918,5967
3/22/2021,1616385600000,7,7,0,0,7321,865,11,607,10.714285714285714,263,0.2857142857142857,11,0,812239,5983.285714285715
3/23/2021,1616472000000,12,12,0,0,6444,877,11.285714285714286,619,11,263,0.2857142857142857,11,0,818683,5984.142857142857
3/24/2021,1616558400000,24,23,1,0,6113,901,12.142857142857142,642,11.714285714285714,264,0.42857142857142855,11,0,824796,5977
3/25/2021,1616644800000,30,28,2,0,6863,931,13.285714285714286,670,12.714285714285714,266,0.5714285714285714,11,0,831659,5956
3/26/2021,1616731200000,18,17,1,0,6969,949,14.428571428571429,687,13.714285714285714,267,0.7142857142857143,11,0,838628,5956.571428571428
3/27/2021,1616817600000,13,13,0,0,4395,962,15.428571428571429,700,14.714285714285714,267,0.7142857142857143,11,0,843023,5939.571428571428
3/28/2021,1616904000000,9,6,3,0,3703,971,16.142857142857142,706,15.142857142857142,270,1,11,0,846726,5972.571428571428
3/29/2021,1616990400000,14,14,0,0,7166,985,17.142857142857142,720,16.142857142857142,270,1,11,0,853892,5950.428571428572
3/30/2021,1617076800000,11,9,2,0,6820,996,17,729,15.714285714285714,272,1.2857142857142858,11,0,860712,6004.142857142857
3/31/2021,1617163200000,3,3,0,0,6320,999,14,732,12.857142857142858,272,1.1428571428571428,11,0,867032,6033.714285714285
4/1/2021,1617249600000,1,1,0,0,6724,1000,9.857142857142858,733,9,272,0.8571428571428571,11,0,873756,6013.857142857143
4/2/2021,1617336000000,4,4,0,0,6688,1004,7.857142857142857,737,7.142857142857143,272,0.7142857142857143,11,0,880444,5973.714285714285
4/3/2021,1617422400000,5,5,0,0,4434,1009,6.714285714285714,742,6,272,0.7142857142857143,11,0,884878,5979.285714285715
4/4/2021,1617508800000,2,2,0,0,3452,1011,5.714285714285714,744,5.428571428571429,272,0.2857142857142857,11,0,888330,5943.428571428572
4/5/2021,1617595200000,1,1,0,0,7002,1012,3.857142857142857,745,3.5714285714285716,272,0.2857142857142857,11,0,895332,5920
4/6/2021,1617681600000,3,2,1,0,6448,1015,2.7142857142857144,747,2.5714285714285716,273,0.14285714285714285,11,0,901780,5866.857142857143
4/7/2021,1617768000000,2,1,1,0,6045,1017,2.5714285714285716,748,2.2857142857142856,274,0.2857142857142857,11,0,907825,5827.571428571428
4/8/2021,1617854400000,1,0,1,0,6598,1018,2.5714285714285716,748,2.142857142857143,275,0.42857142857142855,11,0,914423,5809.571428571428
4/9/2021,1617940800000,5,1,4,0,6435,1023,2.7142857142857144,749,1.7142857142857142,279,1,11,0,920858,5773.428571428572
4/10/2021,1618027200000,2,2,0,0,4476,1025,2.2857142857142856,751,1.2857142857142858,279,1,11,0,925334,5779.428571428572
4/11/2021,1618113600000,2,1,1,0,3571,1027,2.2857142857142856,752,1.1428571428571428,280,1.1428571428571428,11,0,928905,5796.428571428572
4/12/2021,1618200000000,2,1,1,0,7080,1029,2.4285714285714284,753,1.1428571428571428,281,1.2857142857142858,11,0,935985,5807.571428571428
4/13/2021,1618286400000,2,2,0,0,6578,1031,2.2857142857142856,755,1.1428571428571428,281,1.1428571428571428,11,0,942563,5826.142857142857
4/14/2021,1618372800000,1,3,1,0,6014,1032,2.142857142857143,758,1.4285714285714286,282,1.1428571428571428,11,0,948577,5821.714285714285
4/15/2021,1618459200000,3,1,2,0,6709,1035,2.4285714285714284,759,1.5714285714285714,284,1.2857142857142858,11,0,955286,5837.571428571428
4/16/2021,1618545600000,1,1,0,0,6472,1036,1.8571428571428572,760,1.5714285714285714,284,0.7142857142857143,11,0,961758,5842.857142857143
4/17/2021,1618632000000,3,1,2,0,4526,1039,2,761,1.4285714285714286,286,1,11,0,966284,5850
4/18/2021,1618718400000,0,0,0,0,3773,1039,1.7142857142857142,761,1.2857142857142858,286,0.8571428571428571,11,0,970057,5878.857142857143
4/19/2021,1618804800000,1,0,1,0,7118,1040,1.5714285714285714,761,1.1428571428571428,287,0.8571428571428571,11,0,977175,5884.285714285715
4/20/2021,1618891200000,0,0,0,0,5435,1040,1.2857142857142858,761,0.8571428571428571,287,0.8571428571428571,11,0,982610,5721
4/21/2021,1618977600000,0,0,0,0,4898,1040,1.1428571428571428,761,0.42857142857142855,287,0.7142857142857143,11,0,987508,5561.571428571428
4/22/2021,1619064000000,2,1,1,0,5506,1042,1,762,0.42857142857142855,288,0.5714285714285714,11,0,993014,5389.714285714285
4/23/2021,1619150400000,1,1,0,0,5017,1043,1,763,0.42857142857142855,288,0.5714285714285714,11,0,998031,5181.857142857143
4/24/2021,1619236800000,0,0,0,0,3292,1043,0.5714285714285714,763,0.2857142857142857,288,0.2857142857142857,11,0,1001323,5005.571428571428
4/25/2021,1619323200000,0,0,0,0,3411,1043,0.5714285714285714,763,0.2857142857142857,288,0.2857142857142857,11,0,1004734,4953.857142857143
4/26/2021,1619409600000,0,0,0,0,5152,1043,0.42857142857142855,763,0.2857142857142857,288,0.14285714285714285,11,0,1009886,4673
4/27/2021,1619496000000,0,0,0,0,5021,1043,0.42857142857142855,763,0.2857142857142857,288,0.14285714285714285,11,0,1014907,4613.857142857143
4/28/2021,1619582400000,0,0,0,0,4610,1043,0.42857142857142855,763,0.2857142857142857,288,0.14285714285714285,11,0,1019517,4572.714285714285
4/29/2021,1619668800000,2,0,2,0,5054,1045,0.42857142857142855,763,0.14285714285714285,290,0.2857142857142857,11,0,1024571,4508.142857142857
4/30/2021,1619755200000,0,0,0,0,4864,1045,0.2857142857142857,763,0,290,0.2857142857142857,11,0,1029435,4486.285714285715
5/1/2021,1619841600000,2,0,2,0,3318,1047,0.5714285714285714,763,0,292,0.5714285714285714,11,0,1032753,4490
5/2/2021,1619928000000,1,1,0,0,3824,1048,0.7142857142857143,764,0.14285714285714285,292,0.5714285714285714,11,0,1036577,4549
5/3/2021,1620014400000,1,1,0,0,5092,1049,0.8571428571428571,765,0.2857142857142857,292,0.5714285714285714,11,0,1041669,4540.428571428572
5/4/2021,1620100800000,1,1,0,0,4464,1050,1,766,0.42857142857142855,292,0.5714285714285714,11,0,1046133,4460.857142857143
5/5/2021,1620187200000,2,0,2,0,4195,1052,1.2857142857142858,766,0.42857142857142855,294,0.8571428571428571,11,0,1050328,4401.571428571428
5/6/2021,1620273600000,1,0,1,0,4612,1053,1.1428571428571428,766,0.42857142857142855,295,0.7142857142857143,11,0,1054940,4338.428571428572
5/7/2021,1620360000000,1,1,0,0,4464,1054,1.2857142857142858,767,0.5714285714285714,295,0.7142857142857143,11,0,1059404,4281.285714285715
5/8/2021,1620446400000,0,0,0,0,3254,1054,1,767,0.5714285714285714,295,0.42857142857142855,11,0,1062658,4272.142857142857
5/9/2021,1620532800000,0,0,0,0,3767,1054,0.8571428571428571,767,0.42857142857142855,295,0.42857142857142855,11,0,1066425,4264
5/10/2021,1620619200000,1,1,0,0,4718,1055,0.8571428571428571,768,0.42857142857142855,295,0.42857142857142855,11,0,1071143,4210.571428571428
5/11/2021,1620705600000,0,0,0,0,4137,1055,0.7142857142857143,768,0.2857142857142857,295,0.42857142857142855,11,0,1075280,4163.857142857143
5/12/2021,1620792000000,1,0,1,0,3790,1056,0.5714285714285714,768,0.2857142857142857,296,0.2857142857142857,11,0,1079070,4106
5/13/2021,1620878400000,0,0,0,0,4149,1056,0.42857142857142855,768,0.2857142857142857,296,0.14285714285714285,11,0,1083219,4039.8571428571427
5/14/2021,1620964800000,1,1,0,0,3820,1057,0.42857142857142855,769,0.2857142857142857,296,0.14285714285714285,11,0,1087039,3947.8571428571427
5/15/2021,1621051200000,1,1,0,0,2883,1058,0.5714285714285714,770,0.42857142857142855,296,0.14285714285714285,11,0,1089922,3894.8571428571427
5/16/2021,1621137600000,1,0,1,0,3645,1059,0.7142857142857143,770,0.42857142857142855,297,0.2857142857142857,11,0,1093567,3877.4285714285716
5/17/2021,1621224000000,0,0,0,0,4098,1059,0.5714285714285714,770,0.2857142857142857,297,0.2857142857142857,11,0,1097665,3788.8571428571427
5/18/2021,1621310400000,0,0,0,0,3413,1059,0.5714285714285714,770,0.2857142857142857,297,0.2857142857142857,11,0,1101078,3685.4285714285716
5/19/2021,1621396800000,1,0,1,0,3083,1060,0.5714285714285714,770,0.2857142857142857,298,0.2857142857142857,11,0,1104161,3584.4285714285716
5/20/2021,1621483200000,0,0,0,0,3275,1060,0.5714285714285714,770,0.2857142857142857,298,0.2857142857142857,11,0,1107436,3459.5714285714284
5/21/2021,1621569600000,1,0,1,0,3267,1061,0.5714285714285714,770,0.14285714285714285,299,0.42857142857142855,11,0,1110703,3380.5714285714284
5/22/2021,1621656000000,0,0,0,0,2608,1061,0.42857142857142855,770,0,299,0.42857142857142855,11,0,1113311,3341.285714285714
5/23/2021,1621742400000,2,0,2,0,3017,1063,0.5714285714285714,770,0,301,0.5714285714285714,11,0,1116328,3251.5714285714284
5/24/2021,1621828800000,0,0,0,0,3271,1063,0.5714285714285714,770,0,301,0.5714285714285714,11,0,1119599,3133.4285714285716
5/25/2021,1621915200000,0,0,0,0,2279,1063,0.5714285714285714,770,0,301,0.5714285714285714,11,0,1121878,2971.4285714285716
5/26/2021,1622001600000,2,0,2,0,1961,1065,0.7142857142857143,770,0,303,0.7142857142857143,11,0,1123839,2811.1428571428573
5/27/2021,1622088000000,0,0,0,0,2315,1065,0.7142857142857143,770,0,303,0.7142857142857143,11,0,1126154,2674
5/28/2021,1622174400000,1,0,1,0,1768,1066,0.7142857142857143,770,0,304,0.7142857142857143,11,0,1127922,2459.8571428571427
5/29/2021,1622260800000,0,0,0,0,478,1066,0.7142857142857143,770,0,304,0.7142857142857143,11,0,1128400,2155.5714285714284
5/30/2021,1622347200000,0,0,0,0,584,1066,0.42857142857142855,770,0,304,0.42857142857142855,11,0,1128984,1808
5/31/2021,1622433600000,0,0,0,0,9,1066,0.42857142857142855,770,0,304,0.42857142857142855,11,0,1128993,1342
6/1/2021,1622520000000,0,0,0,0,1179,1066,0.42857142857142855,770,0,304,0.42857142857142855,11,0,1130172,1184.857142857143
6/2/2021,1622606400000,0,0,0,0,404,1066,0.14285714285714285,770,0,304,0.14285714285714285,11,0,1130576,962.4285714285714
6/3/2021,1622692800000,0,0,0,0,618,1066,0.14285714285714285,770,0,304,0.14285714285714285,11,0,1131194,720
6/4/2021,1622779200000,0,0,0,0,238,1066,0,770,0,304,0,11,0,1131432,501.42857142857144
6/5/2021,1622865600000,0,0,0,0,24,1066,0,770,0,304,0,11,0,1131456,436.57142857142856
6/6/2021,1622952000000,0,0,0,0,104,1066,0,770,0,304,0,11,0,1131560,368
6/7/2021,1623038400000,0,0,0,0,589,1066,0,770,0,304,0,11,0,1132149,450.85714285714283
6/8/2021,1623124800000,0,0,0,0,309,1066,0,770,0,304,0,11,0,1132458,326.57142857142856
6/9/2021,1623211200000,0,0,0,0,356,1066,0,770,0,304,0,11,0,1132814,319.7142857142857
6/10/2021,1623297600000,0,0,0,0,429,1066,0,770,0,304,0,11,0,1133243,292.7142857142857
6/11/2021,1623384000000,0,0,0,0,188,1066,0,770,0,304,0,11,0,1133431,285.57142857142856
6/12/2021,1623470400000,0,0,0,0,20,1066,0,770,0,304,0,11,0,1133451,285
6/13/2021,1623556800000,0,0,0,0,106,1066,0,770,0,304,0,11,0,1133557,285.2857142857143
6/14/2021,1623643200000,0,0,0,0,527,1066,0,770,0,304,0,11,0,1134084,276.42857142857144
6/15/2021,1623729600000,0,0,0,0,369,1066,0,770,0,304,0,11,0,1134453,285
6/16/2021,1623816000000,1,1,0,0,452,1067,0.14285714285714285,771,0.14285714285714285,304,0,11,0,1134905,298.7142857142857
6/17/2021,1623902400000,0,0,0,0,471,1067,0.14285714285714285,771,0.14285714285714285,304,0,11,0,1135376,304.7142857142857
6/18/2021,1623988800000,0,0,0,0,24,1067,0.14285714285714285,771,0.14285714285714285,304,0,11,0,1135400,281.2857142857143
6/19/2021,1624075200000,0,0,0,0,13,1067,0.14285714285714285,771,0.14285714285714285,304,0,11,0,1135413,280.2857142857143
6/20/2021,1624161600000,0,0,0,0,67,1067,0.14285714285714285,771,0.14285714285714285,304,0,11,0,1135480,274.7142857142857
6/21/2021,1624248000000,0,0,0,0,474,1067,0.14285714285714285,771,0.14285714285714285,304,0,11,0,1135954,267.14285714285717
6/22/2021,1624334400000,0,0,0,0,313,1067,0.14285714285714285,771,0.14285714285714285,304,0,11,0,1136267,259.14285714285717
6/23/2021,1624420800000,0,0,0,0,287,1067,0,771,0,304,0,11,0,1136554,235.57142857142858
6/24/2021,1624507200000,0,0,0,0,454,1067,0,771,0,304,0,11,0,1137008,233.14285714285714
6/25/2021,1624593600000,0,0,0,0,137,1067,0,771,0,304,0,11,0,1137145,249.28571428571428
6/26/2021,1624680000000,0,0,0,0,17,1067,0,771,0,304,0,11,0,1137162,249.85714285714286
6/27/2021,1624766400000,1,0,1,0,50,1068,0.14285714285714285,771,0,305,0.14285714285714285,11,0,1137212,247.42857142857142
6/28/2021,1624852800000,0,0,0,0,405,1068,0.14285714285714285,771,0,305,0.14285714285714285,11,0,1137617,237.57142857142858
6/29/2021,1624939200000,0,0,0,0,247,1068,0.14285714285714285,771,0,305,0.14285714285714285,11,0,1137864,228.14285714285714
6/30/2021,1625025600000,0,0,0,0,255,1068,0.14285714285714285,771,0,305,0.14285714285714285,11,0,1138119,223.57142857142858
7/1/2021,1625112000000,0,0,0,0,328,1068,0.14285714285714285,771,0,305,0.14285714285714285,11,0,1138447,205.57142857142858
7/2/2021,1625198400000,1,0,1,0,96,1069,0.2857142857142857,771,0,306,0.2857142857142857,11,0,1138543,199.71428571428572
7/3/2021,1625284800000,0,0,0,0,25,1069,0.2857142857142857,771,0,306,0.2857142857142857,11,0,1138568,200.85714285714286
7/4/2021,1625371200000,0,0,0,0,1,1069,0.14285714285714285,771,0,306,0.14285714285714285,11,0,1138569,193.85714285714286
7/5/2021,1625457600000,0,0,0,0,10,1069,0.14285714285714285,771,0,306,0.14285714285714285,11,0,1138579,137.42857142857142
7/6/2021,1625544000000,0,0,0,0,379,1069,0.14285714285714285,771,0,306,0.14285714285714285,11,0,1138958,156.28571428571428
7/7/2021,1625630400000,0,0,0,0,264,1069,0.14285714285714285,771,0,306,0.14285714285714285,11,0,1139222,157.57142857142858
7/8/2021,1625716800000,0,0,0,0,280,1069,0.14285714285714285,771,0,306,0.14285714285714285,11,0,1139502,150.71428571428572
7/9/2021,1625803200000,0,0,0,0,82,1069,0,771,0,306,0,11,0,1139584,148.71428571428572
7/10/2021,1625889600000,0,0,0,0,1,1069,0,771,0,306,0,11,0,1139585,145.28571428571428
7/11/2021,1625976000000,0,0,0,0,27,1069,0,771,0,306,0,11,0,1139612,149
7/12/2021,1626062400000,1,1,0,0,295,1070,0.14285714285714285,772,0.14285714285714285,306,0,11,0,1139907,189.71428571428572
7/13/2021,1626148800000,0,0,0,0,232,1070,0.14285714285714285,772,0.14285714285714285,306,0,11,0,1140139,168.71428571428572
7/14/2021,1626235200000,0,0,0,0,220,1070,0.14285714285714285,772,0.14285714285714285,306,0,11,0,1140359,162.42857142857142
7/15/2021,1626321600000,1,1,0,0,226,1071,0.2857142857142857,773,0.2857142857142857,306,0,11,0,1140585,154.71428571428572
7/16/2021,1626408000000,0,0,0,0,96,1071,0.2857142857142857,773,0.2857142857142857,306,0,11,0,1140681,156.71428571428572
7/17/2021,1626494400000,0,0,0,0,5,1071,0.2857142857142857,773,0.2857142857142857,306,0,11,0,1140686,157.28571428571428
7/18/2021,1626580800000,0,0,0,0,10,1071,0.2857142857142857,773,0.2857142857142857,306,0,11,0,1140696,154.85714285714286
7/19/2021,1626667200000,0,0,0,0,262,1071,0.14285714285714285,773,0.14285714285714285,306,0,11,0,1140958,150.14285714285714
7/20/2021,1626753600000,0,0,0,0,225,1071,0.14285714285714285,773,0.14285714285714285,306,0,11,0,1141183,149.14285714285714
7/21/2021,1626840000000,0,0,0,0,241,1071,0.14285714285714285,773,0.14285714285714285,306,0,11,0,1141424,152.14285714285714
7/22/2021,1626926400000,4,2,2,0,247,1075,0.5714285714285714,775,0.2857142857142857,308,0.2857142857142857,11,0,1141671,155.14285714285714
7/23/2021,1627012800000,2,1,1,0,82,1077,0.8571428571428571,776,0.42857142857142855,309,0.42857142857142855,11,0,1141753,153.14285714285714
7/24/2021,1627099200000,0,0,0,0,4,1077,0.8571428571428571,776,0.42857142857142855,309,0.42857142857142855,11,0,1141757,153
7/25/2021,1627185600000,0,0,0,0,29,1077,0.8571428571428571,776,0.42857142857142855,309,0.42857142857142855,11,0,1141786,155.71428571428572
7/26/2021,1627272000000,0,0,0,0,318,1077,0.8571428571428571,776,0.42857142857142855,309,0.42857142857142855,11,0,1142104,163.71428571428572
7/27/2021,1627358400000,2,1,1,0,254,1079,1.1428571428571428,777,0.5714285714285714,310,0.5714285714285714,11,0,1142358,167.85714285714286
7/28/2021,1627444800000,1,1,0,0,306,1080,1.2857142857142858,778,0.7142857142857143,310,0.5714285714285714,11,0,1142664,177.14285714285714
7/29/2021,1627531200000,3,2,1,0,378,1083,1.1428571428571428,780,0.7142857142857143,311,0.42857142857142855,11,0,1143042,195.85714285714286
7/30/2021,1627617600000,5,4,1,0,241,1088,1.5714285714285714,784,1.1428571428571428,312,0.42857142857142855,11,0,1143283,218.57142857142858
7/31/2021,1627704000000,0,0,0,0,1,1088,1.5714285714285714,784,1.1428571428571428,312,0.42857142857142855,11,0,1143284,218.14285714285714
8/1/2021,1627790400000,0,0,0,0,57,1088,1.5714285714285714,784,1.1428571428571428,312,0.42857142857142855,11,0,1143341,222.14285714285714
8/2/2021,1627876800000,0,0,0,0,523,1088,1.5714285714285714,784,1.1428571428571428,312,0.42857142857142855,11,0,1143864,251.42857142857142
8/3/2021,1627963200000,1,0,1,0,318,1089,1.4285714285714286,784,1,313,0.42857142857142855,11,0,1144182,260.57142857142856
8/4/2021,1628049600000,0,0,0,0,322,1089,1.2857142857142858,784,0.8571428571428571,313,0.42857142857142855,11,0,1144504,262.85714285714283
8/5/2021,1628136000000,3,0,3,0,326,1092,1.2857142857142858,784,0.5714285714285714,316,0.7142857142857143,11,0,1144830,255.42857142857142
8/6/2021,1628222400000,1,0,1,0,213,1093,0.7142857142857143,784,0,317,0.7142857142857143,11,0,1145043,251.42857142857142
8/7/2021,1628308800000,0,0,0,0,,1093,0.7142857142857143,784,0,317,0.7142857142857143,11,0,1145043,251.28571428571428
8/8/2021,1628395200000,0,0,0,0,94,1093,0.7142857142857143,784,0,317,0.7142857142857143,11,0,1145137,256.57142857142856
8/9/2021,1628481600000,2,1,1,0,973,1095,1,785,0.14285714285714285,318,0.8571428571428571,11,0,1146110,320.85714285714283
8/10/2021,1628568000000,2,1,1,0,812,1097,1.1428571428571428,786,0.2857142857142857,319,0.8571428571428571,11,0,1146922,391.42857142857144
8/11/2021,1628654400000,6,3,3,0,645,1103,2,789,0.7142857142857143,322,1.2857142857142858,11,0,1147567,437.57142857142856
8/12/2021,1628740800000,6,4,2,0,832,1109,2.4285714285714284,793,1.2857142857142858,324,1.1428571428571428,11,0,1148399,509.85714285714283
8/13/2021,1628827200000,3,1,2,0,291,1112,2.7142857142857144,794,1.4285714285714286,326,1.2857142857142858,11,0,1148690,521
8/14/2021,1628913600000,0,0,0,0,2,1112,2.7142857142857144,794,1.4285714285714286,326,1.2857142857142858,11,0,1148692,521.2857142857143
8/15/2021,1629000000000,0,0,0,0,227,1112,2.7142857142857144,794,1.4285714285714286,326,1.2857142857142858,11,0,1148919,540.2857142857143
8/16/2021,1629086400000,2,0,2,0,1458,1114,2.7142857142857144,794,1.2857142857142858,328,1.4285714285714286,11,0,1150377,609.5714285714286
8/17/2021,1629172800000,4,1,3,0,1355,1118,3,795,1.2857142857142858,331,1.7142857142857142,11,0,1151732,687.1428571428571
8/18/2021,1629259200000,3,1,2,0,1344,1121,2.5714285714285716,796,1,333,1.5714285714285714,11,0,1153076,787
8/19/2021,1629345600000,6,1,5,0,1580,1127,2.5714285714285716,797,0.5714285714285714,338,2,11,0,1154656,893.8571428571429
8/20/2021,1629432000000,3,3,0,0,674,1130,2.5714285714285716,800,0.8571428571428571,338,1.7142857142857142,11,0,1155330,948.5714285714286
8/21/2021,1629518400000,12,8,4,0,425,1142,4.285714285714286,808,2,342,2.2857142857142856,11,0,1155755,1009
8/22/2021,1629604800000,1,1,0,0,213,1143,4.428571428571429,809,2.142857142857143,342,2.2857142857142856,11,0,1155968,1007
8/23/2021,1629691200000,5,2,3,0,3681,1148,4.857142857142857,811,2.4285714285714284,345,2.4285714285714284,11,0,1159649,1324.5714285714287
8/24/2021,1629777600000,3,2,1,0,4060,1151,4.714285714285714,813,2.5714285714285716,346,2.142857142857143,11,0,1163709,1711
8/25/2021,1629864000000,11,11,0,0,4179,1162,5.857142857142857,824,4,346,1.8571428571428572,11,0,1167888,2116
8/26/2021,1629950400000,25,23,1,1,4961,1187,8.571428571428571,847,7.142857142857143,347,1.2857142857142858,12,0.14285714285714285,1172849,2599
8/27/2021,1630036800000,45,43,2,0,1230,1232,14.571428571428571,890,12.857142857142858,349,1.5714285714285714,12,0.14285714285714285,1174079,2678.4285714285716
8/28/2021,1630123200000,57,57,0,0,836,1289,21,947,19.857142857142858,349,1,12,0.14285714285714285,1174915,2737.1428571428573
8/29/2021,1630209600000,56,55,1,0,3597,1345,28.857142857142858,1002,27.571428571428573,350,1.1428571428571428,12,0.14285714285714285,1178512,3220.5714285714284
8/30/2021,1630296000000,39,39,0,0,5645,1384,33.714285714285715,1041,32.857142857142854,350,0.7142857142857143,12,0.14285714285714285,1184157,3501.1428571428573
8/31/2021,1630382400000,31,31,0,0,4922,1415,37.714285714285715,1072,37,350,0.5714285714285714,12,0.14285714285714285,1189079,3624.285714285714
9/1/2021,1630468800000,52,47,4,1,5776,1467,43.57142857142857,1119,42.142857142857146,354,1.1428571428571428,13,0.2857142857142857,1194855,3852.4285714285716
9/2/2021,1630555200000,43,42,1,0,5321,1510,46.142857142857146,1161,44.857142857142854,355,1.1428571428571428,13,0.14285714285714285,1200176,3903.8571428571427
9/3/2021,1630641600000,29,26,3,0,907,1539,43.857142857142854,1187,42.42857142857143,358,1.2857142857142858,13,0.14285714285714285,1201083,3857.714285714286
9/4/2021,1630728000000,29,28,1,0,497,1568,39.857142857142854,1215,38.285714285714285,359,1.4285714285714286,13,0.14285714285714285,1201580,3809.285714285714
9/5/2021,1630814400000,11,4,7,0,3572,1579,33.42857142857143,1219,31,366,2.2857142857142856,13,0.14285714285714285,1205152,3805.714285714286
9/6/2021,1630900800000,9,9,0,0,3833,1588,29.142857142857142,1228,26.714285714285715,366,2.2857142857142856,13,0.14285714285714285,1208985,3546.8571428571427
9/7/2021,1630987200000,8,8,0,0,5594,1596,25.857142857142858,1236,23.428571428571427,366,2.2857142857142856,13,0.14285714285714285,1214579,3642.8571428571427
9/8/2021,1631073600000,14,13,1,0,5458,1610,20.428571428571427,1249,18.571428571428573,367,1.8571428571428572,13,0,1220037,3597.4285714285716
9/9/2021,1631160000000,14,14,0,0,5300,1624,16.285714285714285,1263,14.571428571428571,367,1.7142857142857142,13,0,1225337,3594.4285714285716
9/10/2021,1631246400000,9,8,1,0,760,1633,13.428571428571429,1271,12,368,1.4285714285714286,13,0,1226097,3573.4285714285716
9/11/2021,1631332800000,12,8,4,0,277,1645,11,1279,9.142857142857142,372,1.8571428571428572,13,0,1226374,3542
9/12/2021,1631419200000,2,1,1,0,3484,1647,9.714285714285714,1280,8.714285714285714,373,1,13,0,1229858,3529.4285714285716
9/13/2021,1631505600000,10,7,3,0,5166,1657,9.857142857142858,1287,8.428571428571429,376,1.4285714285714286,13,0,1235024,3719.8571428571427
9/14/2021,1631592000000,10,8,2,0,4637,1667,10.142857142857142,1295,8.428571428571429,378,1.7142857142857142,13,0,1239661,3583.1428571428573
9/15/2021,1631678400000,8,5,3,0,5022,1675,9.285714285714286,1300,7.285714285714286,381,2,13,0,1244683,3520.8571428571427
9/16/2021,1631764800000,3,3,0,0,5140,1678,7.714285714285714,1303,5.714285714285714,381,2,13,0,1249823,3498
9/17/2021,1631851200000,15,6,9,0,757,1693,8.571428571428571,1309,5.428571428571429,390,3.142857142857143,13,0,1250580,3497.5714285714284
9/18/2021,1631937600000,7,3,3,1,206,1700,7.857142857142857,1312,4.714285714285714,393,3,14,0.14285714285714285,1250786,3487.4285714285716
9/19/2021,1632024000000,1,0,1,0,2925,1701,7.714285714285714,1312,4.571428571428571,394,3,14,0.14285714285714285,1253711,3407.5714285714284
9/20/2021,1632110400000,7,3,4,0,5587,1708,7.285714285714286,1315,4,398,3.142857142857143,14,0.14285714285714285,1259298,3467.714285714286
9/21/2021,1632196800000,8,4,4,0,5169,1716,7,1319,3.4285714285714284,402,3.4285714285714284,14,0.14285714285714285,1264467,3543.714285714286
9/22/2021,1632283200000,9,9,0,0,5013,1725,7.142857142857143,1328,4,402,3,14,0.14285714285714285,1269480,3542.4285714285716
9/23/2021,1632369600000,3,3,0,0,5171,1728,7.142857142857143,1331,4,402,3,14,0.14285714285714285,1274651,3546.8571428571427
9/24/2021,1632456000000,8,8,0,0,836,1736,6.142857142857143,1339,4.285714285714286,402,1.7142857142857142,14,0.14285714285714285,1275487,3558.1428571428573
9/25/2021,1632542400000,1,1,0,0,345,1737,5.285714285714286,1340,4,402,1.2857142857142858,14,0,1275832,3578
9/26/2021,1632628800000,6,0,4,2,3011,1743,6,1340,4,406,1.7142857142857142,16,0.2857142857142857,1278843,3590.285714285714
9/27/2021,1632715200000,0,0,0,0,5362,1743,5,1340,3.5714285714285716,406,1.1428571428571428,16,0.2857142857142857,1284205,3558.1428571428573
9/28/2021,1632801600000,2,2,0,0,5189,1745,4.142857142857143,1342,3.2857142857142856,406,0.5714285714285714,16,0.2857142857142857,1289394,3561
9/29/2021,1632888000000,6,1,4,1,4895,1751,3.7142857142857144,1343,2.142857142857143,410,1.1428571428571428,17,0.42857142857142855,1294289,3544.1428571428573
9/30/2021,1632974400000,0,0,0,0,5240,1751,3.2857142857142856,1343,1.7142857142857142,410,1.1428571428571428,17,0.42857142857142855,1299529,3554
10/1/2021,1633060800000,5,0,5,0,718,1756,2.857142857142857,1343,0.5714285714285714,415,1.8571428571428572,17,0.42857142857142855,1300247,3537.1428571428573
10/2/2021,1633147200000,0,0,0,0,301,1756,2.7142857142857144,1343,0.42857142857142855,415,1.8571428571428572,17,0.42857142857142855,1300548,3530.8571428571427
10/3/2021,1633233600000,0,0,0,0,2622,1756,1.8571428571428572,1343,0.42857142857142855,415,1.2857142857142858,17,0.14285714285714285,1303170,3475.285714285714
10/4/2021,1633320000000,1,1,0,0,5485,1757,2,1344,0.5714285714285714,415,1.2857142857142858,17,0.14285714285714285,1308655,3492.8571428571427
10/5/2021,1633406400000,1,1,0,0,5124,1758,1.8571428571428572,1345,0.42857142857142855,415,1.2857142857142858,17,0.14285714285714285,1313779,3483.5714285714284
10/6/2021,1633492800000,5,3,2,0,4949,1763,1.7142857142857142,1348,0.7142857142857143,417,1,17,0,1318728,3491.285714285714
10/7/2021,1633579200000,1,1,0,0,5275,1764,1.8571428571428572,1349,0.8571428571428571,417,1,17,0,1324003,3496.285714285714
10/8/2021,1633665600000,5,1,4,0,772,1769,1.8571428571428572,1350,1,421,0.8571428571428571,17,0,1324775,3504
10/9/2021,1633752000000,0,0,0,0,151,1769,1.8571428571428572,1350,1,421,0.8571428571428571,17,0,1324926,3482.5714285714284
10/10/2021,1633838400000,0,0,0,0,861,1769,1.8571428571428572,1350,1,421,0.8571428571428571,17,0,1325787,3231
10/11/2021,1633924800000,3,0,3,0,2705,1772,2.142857142857143,1350,0.8571428571428571,424,1.2857142857142858,17,0,1328492,2833.8571428571427
10/12/2021,1634011200000,2,0,2,0,3837,1774,2.2857142857142856,1350,0.7142857142857143,426,1.5714285714285714,17,0,1332329,2650
10/13/2021,1634097600000,2,2,0,0,6735,1776,1.8571428571428572,1352,0.5714285714285714,426,1.2857142857142858,17,0,1339064,2905.1428571428573
10/14/2021,1634184000000,10,7,3,0,5709,1786,3.142857142857143,1359,1.4285714285714286,429,1.7142857142857142,17,0,1344773,2967.1428571428573
10/15/2021,1634270400000,4,3,1,0,1543,1790,3,1362,1.7142857142857142,430,1.2857142857142858,17,0,1346316,3077.285714285714
10/16/2021,1634356800000,2,2,0,0,204,1792,3.2857142857142856,1364,2,430,1.2857142857142858,17,0,1346520,3084.8571428571427
10/17/2021,1634443200000,0,0,0,0,2556,1792,3.2857142857142856,1364,2,430,1.2857142857142858,17,0,1349076,3327
10/18/2021,1634529600000,7,2,5,0,5562,1799,3.857142857142857,1366,2.2857142857142856,435,1.5714285714285714,17,0,1354638,3735.1428571428573
10/19/2021,1634616000000,3,2,1,0,4991,1802,4,1368,2.5714285714285716,436,1.4285714285714286,17,0,1359629,3900
10/20/2021,1634702400000,3,1,2,0,4745,1805,4.142857142857143,1369,2.4285714285714284,438,1.7142857142857142,17,0,1364374,3615.714285714286
10/21/2021,1634788800000,1,1,0,0,5345,1806,2.857142857142857,1370,1.5714285714285714,438,1.2857142857142858,17,0,1369719,3563.714285714286
10/22/2021,1634875200000,8,3,4,1,756,1814,3.4285714285714284,1373,1.5714285714285714,442,1.7142857142857142,18,0.14285714285714285,1370475,3451.285714285714
10/23/2021,1634961600000,1,0,1,0,255,1815,3.2857142857142856,1373,1.2857142857142858,443,1.8571428571428572,18,0.14285714285714285,1370730,3458.5714285714284
10/24/2021,1635048000000,0,0,0,0,2610,1815,3.2857142857142856,1373,1.2857142857142858,443,1.8571428571428572,18,0.14285714285714285,1373340,3466.285714285714
10/25/2021,1635134400000,5,3,2,0,5530,1820,3,1376,1.4285714285714286,445,1.4285714285714286,18,0.14285714285714285,1378870,3461.714285714286
